XXXXXXXXXXX
X X X X   X
X X X X X X
X X X X X X
X X X X X X
X X X X X X
X X X X X X
X X X X   X
X X X X   X
X         X
XXXXXXXXXXX