XXXXXXXXXXXXXXXXXXXXX
X               X   X
X XXXXX XXXXXXXXX X X
X X   X X         X X
X X X X X XXXXXXXXX X
X X X X   X X     X X
X X X XXX X X X   X X
X X X       X X   X X
X X X XXXXXXX X X X X
X X X X     X X X X X
X X X X XXX X X X X X
X       X X X X X X X
X XXXXX X X X XXX X X
X X   X X X X     X X
X X XXX X X X XXX X X
X X   X X X X X X   X
X X X X X X X X XXX X
X X X X     X X   X X
X X X XXXXXXX X XXX X
X                 X X
XXXXXXXXXXXXXXXXXXXXX