XXXXXXXXXXXXXXXXXXXXX
X         X         X
X X XXXXXXX X X XXX X
X X X     X X X X   X
X X X   XXX X X X X X
X X     X   X X X X X
X X XXXXX X X XXX X X
X X X       X   X X X
X XXX XXXXX XXX X X X
X         X   X X X X
X X XXX X X X X X X X
X X X X X X X X X X X
X X X X X XXX X X X X
X X X X X   X X X X X
X X X X XXX X X X X X
X X X X X X   X X X X
X X X X X X X X X X X
X X X X   X X X X X X
X X X XXX XXX X X X X
X       X     X     X
XXXXXXXXXXXXXXXXXXXXX