XXXXXXXXXXXXXXXXXXXXX
X             X     X
X X XXX XXXXX X X X X
X X X   X   X X X X X
X X X X X X XXX X X X
X X X X X X     X   X
X X X XXX X XXX XXX X
X X     X X X X   X X
X X XXX X X X XXX X X
X X X X X X X     X X
X X X X X X X X   X X
X X X       X X   X X
X X X X XXXXX XXX X X
X X X X X       X X X
X X X X X X XXX X X X
X X     X X   X X X X
X XXXXX X X XXXXX X X
X     X X X X     X X
X XXX XXX XXX XXXXX X
X                   X
XXXXXXXXXXXXXXXXXXXXX