XXXXXXXXXXXXXXXXXXXXX
X X X X       X X   X
X X X X X XXX X X X X
X       X X X X   X X
X XXXXX XXX XXX XXX X
X X   X   X X   X   X
X X X XXXXX X XXX X X
X X X         X   X X
X X X XXXXXXXXX X X X
X X X X             X
X X XXX X XXX X XXX X
X       X X X X X X X
X XXXXX X X X XXX X X
X X   X X   X     X X
X X X X XXX XXXXX X X
X X X X   X     X X X
X X XXX XXX XXX X X X
X X   X   X X X X   X
X X XXXXX XXX X X   X
X       X     X     X
XXXXXXXXXXXXXXXXXXXXX