XXXXXXXXXXXXXXXXXXXXX
X                   X
X XXX XXX X X XXXXX X
X X X X X X X X   X X
X X XXX X X X X XXX X
X X     X X   X X X X
X X X X X XXX X X X X
X X X X X   X X X X X
X X XXX XXX XXX X X X
X     X         X X X
X XXX X XXXXXXX X X X
X X   X       X X X X
X X X XXXXX X X X X X
X X X     X X X X   X
X X X X XXX X X X X X
X X   X     X X X X X
X X XXX X XXX X X X X
X X X X X X   X     X
X X X XXX X XXXXX X X
X                 X X
XXXXXXXXXXXXXXXXXXXXX