XXXXXXXXXXXXXXXXXXXXX
X                 X X
X XXXXXXXXX XXX XXX X
X       X X   X     X
X XXXXX X XXX X XXX X
X X         X X X X X
X X XXX XXX XXX X X X
X X X X X X   X X X X
X X X XXX X X X X X X
X         X X X X   X
X XXXXXXX X X XXX X X
X X   X X X X     X X
X X X X X X X X XXX X
X X X X X X X X   X X
X X X X X XXX X X X X
X X X X X     X X X X
X X X X X XXXXXXX X X
X X X X X           X
X X X X XXXXXXXXXXX X
X   X             X X
XXXXXXXXXXXXXXXXXXXXX