XXXXXXXXXXXXXXXXXXXXX
X                 X X
X X XXX XXXXXXXXXXX X
X X X X         X X X
X X X X XXX XXX X X X
X X X X X X X X   X X
X X X X X X X XXXXX X
X X X X   X X       X
X X X XXX X X XXX X X
X X X   X X X X X X X
X X X X X X X X X X X
X X   X X X X X X   X
X XXX X X XXX X XXX X
X   X X X X X X     X
X XXX XXX X X X X   X
X X X X X     X X   X
X X X X X XXX X X   X
X X X   X X X X X   X
X X XXX XXX X X XXX X
X           X     X X
XXXXXXXXXXXXXXXXXXXXX