XXXXXXXXXXXXXXXXXXXXX
X     X X           X
X XXXXX X XXXXXXX X X
X X   X X X X X X X X
X X XXX X X X X X X X
X   X       X X   X X
X XXX X XXXXX X X X X
X X   X X     X X X X
X X X XXX XXX X X X X
X X X X   X X   X X X
X X X X X X X X X X X
X X X X X X X X X X X
X X X X X X X X X X X
X X X X X X X X X X X
X X X X X X X X X X X
X X X X X X X X X   X
X X X X X X XXX X X X
X X X X X X     X X X
X X XXX XXX XXXXX X X
X                   X
XXXXXXXXXXXXXXXXXXXXX