XXXXXXXXXXXXXXXXXXXXX
X                   X
X X X XXXXXXX XXXXX X
X X X X   X X X   X X
X X X X XXX X X X X X
X X X X         X   X
X X XXX XXX XXX X X X
X X     X X X   X X X
X X XXX X X X X X X X
X X X X X X X X X X X
X X X XXX XXX X X X X
X X           X X X X
X XXXXXXXXX X X X X X
X     X   X X X X X X
X XXXXX X XXX X X X X
X       X   X   X X X
X XXXXXXXXX XXX XXX X
X X       X   X     X
X X X X X XXX X X   X
X     X X   X X     X
XXXXXXXXXXXXXXXXXXXXX