XXXXXXXXXXXXXXXXXXXXX
X                   X
X XXX XXXXXXX XXXXX X
X X X X     X X     X
X X X X XXX X X X X X
X X X X X X X X X   X
X X X X X X X X X X X
X X X X X X   X X X X
X X X X X XXX X X X X
X X X   X   X   X X X
X X XXX X X XXX XXX X
X X   X X X   X     X
X X XXX X X X XXXXX X
X X     X X X     X X
X X XXX X X XXXXXXX X
X X X X           X X
X X X X XXXXXXXXX X X
X X X X X       X X X
X X X XXX XXX XXX X X
X                 X X
XXXXXXXXXXXXXXXXXXXXX