XXXXXXXXXXXXXXXXXXXXX
X X                 X
X X XXXXX X XXXXX X X
X X X   X X X   X X X
X X X X X X X X X X X
X X X X X X X X X   X
X X X XXXXX X X X X X
X X X     X   X X X X
X X X XXX XXXXX X X X
X X X X X     X   X X
X X X X XXXXX X X X X
X X     X   X   X X X
X X XXXXX XXX X X X X
X X X       X X   X X
X X X XXXXXXX X XXX X
X X X         X X   X
X X X XXXXX   X X X X
X X X X X X   X X X X
X X X X X XXXXX X X X
X                   X
XXXXXXXXXXXXXXXXXXXXX