XXXXXXXXXXXXXXXXXXXXX
X     X         X X X
X X X X XXX XXXXX X X
X X X X X   X     X X
X X XXX X XXX X X X X
X X   X       X X X X
X X XXX XXX X X X X X
X X     X X X   X X X
X XXXXX X XXX XXX X X
X     X X   X       X
X XXX X X X XXXXX X X
X X X X X X     X X X
X X X X X XXXXX X X X
X X X X X     X X X X
X X X X X X X X X X X
X X X X   X   X X   X
X X X XXX X X X XXX X
X X X   X X X X   X X
X X X X XXX X XXXXX X
X     X           X X
XXXXXXXXXXXXXXXXXXXXX