XXXXXXXXXXXXXXXXXXXXX
X X                 X
X X XXX X XXX X XXX X
X   X X X X X X     X
X XXX X XXX XXX XXX X
X X   X     X   X X X
X X X XXX X X X X X X
X X X X X     X X X X
X X X X XXXXXXX X X X
X X X           X X X
X X XXXXX XXXXX X X X
X X X   X X     X X X
X X X X X X XXXXX X X
X X X X   X X     X X
X X X X XXX X X X X X
X X X X X   X X X X X
X X X X X XXX X XXX X
X X X X X X   X     X
X X X XXX X   XXXXX X
X                   X
XXXXXXXXXXXXXXXXXXXXX