XXXXXXXXXXXXXXXXXXXXX
X                 X X
X X X XXX XXX XXXXX X
X X X X X X   X     X
X X XXX XXX XXX XXX X
X X             X   X
X X XXXXX XXXXX X X X
X X   X X X   X X X X
X X XXX XXX X XXX X X
X X X       X     X X
X XXX XXX X XXXXXXX X
X       X X         X
X X XXX XXXXX XXX   X
X X X X     X X X   X
X X X XXXXX XXX X X X
X X X     X     X X X
X X X X X XXX XXX X X
X X X X X X X X   X X
X X X X X X XXX X X X
X X     X           X
XXXXXXXXXXXXXXXXXXXXX