XXXXXXXXXXXXXXXXXXXXX
X           X       X
X X X XXX XXX XXX X X
X X X   X X   X X X X
X X XXX X X XXX X X X
X X   X X X X   X   X
X XXX X XXX X X XXX X
X   X X X   X X     X
X X X XXX XXX X X X X
X X X           X X X
X X XXXXX XXX X X X X
X X     X X X X X   X
X X XXX X X X X X X X
X X X   X X X X X X X
X X X X X X X X X X X
X   X X X X X   X X X
X X X X X X XXX X X X
X X X   X     X   X X
X XXX X XXXXXXXXX X X
X     X           X X
XXXXXXXXXXXXXXXXXXXXX