XXXXXXXXXXXXXXXXXXXXX
X                   X
X XXXXX XXX XXX X X X
X X   X   X X X X X X
X X X XXX X X X X X X
X X X   X X X X X X X
X X X X X X X X X X X
X X X X X X X   X   X
X X X X X X X X X   X
X X X X X X X X X   X
X X X X X X X X X   X
X X X X X X X X X   X
X X X X X X X XXX X X
X X X X X X X X X X X
X X X X X XXX X X X X
X X X X X     X X X X
X X X X XXXXXXX X X X
X X X X       X X X X
X X X XXXXXXXXX XXX X
X   X               X
XXXXXXXXXXXXXXXXXXXXX