XXXXXXXXXXXXXXXXXXXXX
X       X     X     X
X XXX X X XXX X XXX X
X X X X   X X X X X X
X X X XXX X XXX X X X
X X X   X       X X X
X X XXX XXX XXX X X X
X X   X   X X X   X X
X X   X X XXX XXXXX X
X     X X       X X X
X XXX XXX XXX X X X X
X X X     X X X X X X
X X XXXXX X X X X X X
X X     X   X X   X X
X X X X X X X XXXXX X
X X X X X X X     X X
X X X XXX X XXXXX X X
X X X X X X   X X X X
X X XXX XXX XXX XXX X
X                   X
XXXXXXXXXXXXXXXXXXXXX