XXXXXXXXXXXXXXXXXXXXX
X     X             X
X X XXX X X XXXXX X X
X X X   X X     X X X
X X X X X XXXXX X X X
X X X X X     X   X X
X X X X XXXXX X X X X
X X X X   X   X X X X
X X X XXXXX   X X X X
X X X         X X X X
X XXX XXXXX XXX X X X
X     X     X X X X X
X X X X XXX X X X X X
X X X X X X   X X X X
X X X X X XXX X X X X
X X     X   X X X X X
X X XXXXX X X X X X X
X X     X X X     X X
X XXXXXXX X XXXXX X X
X         X     X   X
XXXXXXXXXXXXXXXXXXXXX