XXXXXXXXXXXXXXXXXXXXX
X     X             X
X X XXX XXXXX XXXXX X
X X X   X   X     X X
X X X X X X X XXX X X
X X   X X X X X   X X
X X XXXXX X XXX   X X
X X X     X       X X
X XXX XXX XXX XXX X X
X     X   X     X X X
X X XXX XXX XXX X X X
X X           X X X X
X XXX XXXXXXX X X X X
X   X X X   X   X   X
X X X X X X X X X X X
X X X       X X X X X
X X X XXXXX XXX X X X
X X X X   X     X X X
X X XXX X XXX XXX X X
X       X   X   X   X
XXXXXXXXXXXXXXXXXXXXX