XXXXXXXXXXXXXXXXXXXXX
X           X       X
X   XXX XXX X XXX X X
X   X X   X X X X X X
X   X XXX X X X X X X
X   X   X X X X X X X
X XXX X X X X X XXX X
X X   X   X X X     X
X X XXX XXXXX X X X X
X X X X X     X X X X
X X X XXX XXX X X X X
X         X X X X X X
X XXXXXXXXX X X XXX X
X X       X X     X X
X X XXX XXX XXXXXXX X
X X X X           X X
X X X X XXX XXX   X X
X X X X X   X X   X X
X X X XXX XXX XXX X X
X               X   X
XXXXXXXXXXXXXXXXXXXXX