XXXXXXXXXXXXXXXXXXXXX
X                   X
X X XXXXXXXXXXXXXXX X
X X                 X
X X XXX X XXXXX XXX X
X X X X   X     X X X
X X X XXX X XXX X X X
X X X   X   X X   X X
X XXX X XXX X XXX X X
X     X X X X   X X X
X X X X X X X X X X X
X X   X     X X   X X
X X XXX X X X XXX X X
X X X X X X X   X   X
X X X X X X X X XXX X
X X   X X X X X   X X
X XXX X X X X XXX X X
X   X X   X X   X X X
X X X XXXXXXX   XXX X
X   X             X X
XXXXXXXXXXXXXXXXXXXXX