XXXXXXXXXXXXXXXXXXXXX
X       X         X X
X XXX XXX XXXXXXXXX X
X   X X   X         X
X X X X X X XXX X X X
X X   X X X X   X X X
X X XXX X X X X X X X
X X X X X   X X X X X
X X X X X XXX X X X X
X X X X X X     X X X
X X X X X X X X X X X
X X X X X   X X X X X
X X X X XXX X X X X X
X X X X X   X X X X X
X X X X X XXX X X X X
X X X X X X   X X X X
X X X X X X X X X X X
X X X X X X X X   X X
X X X X X X X XXXXX X
X           X       X
XXXXXXXXXXXXXXXXXXXXX