XXXXXXXXXXXXXXXXXXXXX
X                   X
X X XXX X XXX XXXXX X
X X X X X   X   X X X
X X X X XXXXXXX X X X
X X X X         X X X
X XXX X X XXXXX X X X
X     X X X X X X X X
X X XXX XXX X X X X X
X X X X     X X   X X
X X X XXXXX X XXXXX X
X     X   X X     X X
X XXX X X XXX XXX X X
X X X X             X
X X X X XXX XXXXXXX X
X X X   X   X     X X
X X XXXXX X X XXX X X
X X       X X X X   X
X X X X   XXX X XXX X
X   X             X X
XXXXXXXXXXXXXXXXXXXXX