XXXXXXXXXXXXXXXXXXXXX
X                 X X
X X XXX XXX XXX XXX X
X X X X   X X X X X X
X X X XXX X X X X X X
X X X   X X   X X X X
X X X X X XXX X X X X
X X X X X   X X X X X
X X X XXXXX XXX X X X
X X X           X X X
X X X XXXXXXX X X X X
X X   X     X X X X X
X XXX X X X XXX X X X
X   X   X           X
X X XXX XXXXX X XXX X
X X   X     X X X X X
X X XXXXX X X XXX X X
X X   X     X X   X X
X XXXXX XXXXXXX XXX X
X                 X X
XXXXXXXXXXXXXXXXXXXXX