XXXXXXXXXXXXXXXXXXXXX
X                 X X
X X XXXXX   XXXXXXX X
X X   X X   X     X X
X X XXX XXX X X XXX X
X X X     X X X X   X
X X X X   XXX X X X X
X X X X         X X X
X X X X XXX XXX X X X
X X X X X X   X X X X
X X X X X XXX X X X X
X X     X   X X   X X
X X XXX X X X X XXX X
X X X X X X X X X   X
X XXX XXX X X XXX X X
X         X   X   X X
X X XXXXXXXXX X XXX X
X X         X   X   X
X XXXXXXXXXXXXXXX   X
X                   X
XXXXXXXXXXXXXXXXXXXXX