XXXXXXXXXXXXXXXXXXXXX
X   X               X
X X X X   XXXXX XXX X
X X X X   X     X X X
X X X X XXX X XXX X X
X X X X X   X X X   X
X X X X X X X X X X X
X X X X X X X X X X X
X X X X X X XXX X X X
X X X X X X   X     X
X X X X X XXX X XXX X
X X X X X   X X X   X
X X X X X X X X X X X
X X X X X X X X X X X
X X X X X X XXX X X X
X X X X         X X X
X X X XXXXXXXXX X X X
X X         X X   X X
X XXXXXXXXXXX XXX X X
X               X X X
XXXXXXXXXXXXXXXXXXXXX