XXXXXXXXXXXXXXXXXXXXX
X     X             X
X X X X X X X XXXXX X
X X X     X X X     X
X X X XXX X XXX X X X
X X X X X   X X X X X
X X X X XXX X X X X X
X X X X   X   X X X X
X X X X X X XXX X X X
X X X X X   X   X X X
X X X X X X X X X X X
X X X X X X X X X X X
X X XXX X X X X XXX X
X X     X X X X   X X
X XXXXX X X X X X X X
X       X X X X X   X
X X XXXXX X X XXX X X
X X X   X   X     X X
X XXX X XXXXX XXX X X
X                   X
XXXXXXXXXXXXXXXXXXXXX