XXXXXXXXXXXXXXXXXXXXX
X   X       X       X
X XXX XXXXX X XXX X X
X X         X X X X X
X X XXXXXXXXX X X X X
X             X   X X
X XXXXXXX XXXXX X X X
X X     X       X X X
X X XXX X XXX X X X X
X X X X X X X X X X X
X X X X X X X X X X X
X     X X X X   X X X
X XXXXX X X XXX X X X
X X   X X X   X     X
X X X X XXX XXXXXXX X
X X X X           X X
X X X XXXXXXX X X X X
X X X     X X X X X X
X X X XXXXX XXX X X X
X                 X X
XXXXXXXXXXXXXXXXXXXXX