XXXXXXXXXXXXXXXXXXXXX
X   X           X   X
X X X XXX X XXXXX X X
X X   X X X X X   X X
X X XXX X XXX X   X X
X X X   X X   X   X X
X X X XXX X XXX X X X
X X X X X       X X X
X X X X XXXXXXXXX X X
X X   X         X X X
X XXX X XXXXXXXXX X X
X   X     X         X
X X X XXX X X X X X X
X X X X X X X X X X X
X X XXX X X XXX XXX X
X X X   X X X X     X
X X X X X X X X X X X
X X X X X     X   X X
X X X XXXXXXX XXX X X
X               X X X
XXXXXXXXXXXXXXXXXXXXX