XXXXXXXXXXX
X         X
X XXXXXXX X
X X       X
X X X X X X
X X X X X X
X X XXX X X
X X   X X X
X X X X X X
X     X   X
XXXXXXXXXXX