XXXXXXXXXXX
X         X
X X X X X X
X X X X X X
X X X X X X
X X     X X
X X X XXX X
X X X     X
X X XXX   X
X X   X   X
XXXXXXXXXXX