XXXXXXXXXXXXXXXXX
X     X         X
X X XXX XXX XXX X
X X X   X   X   X
X X X XXX XXX   X
X X X X   X     X
X XXX X XXX XXX X
X         X X X X
X XXX XXXXX X X X
X X X X   X X X X
X X X X XXX X X X
X X X X X   X X X
X X X X X XXX X X
X X X   X X   X X
X X XXX X X XXX X
X               X
XXXXXXXXXXXXXXXXX